|||||||||||||||||||||||||||||||||||||||||||||||||||||||||||||
| | |   |   | |     | |         | | |     |     |     |     |
| | ||| | | | | | ||| | | | ||| | | ||||| | | | ||| ||||| |||
| | |   | | | | | |     | |   | | | | |   | | | | | |       |
| | | ||||| | | ||| ||| ||||| | | | | | ||| | | | | ||||| | |
| |             |     | | |   | |   |   | | | | | |       | |
| ||||| ||| ||||| | ||| | | | ||||| | ||| | | ||| | ||||||| |
|   |   | |     | | | |   | |       |     | |   |   |   |   |
| ||||||| ||| | ||| | ||| | | | ||||| | ||| | ||||||| ||| |||
| | |   | |   | | |   | | | | | |   | | |   | |     |   | | |
| | | | | ||| | | ||| | | ||||| | | | ||| ||||| | ||| ||| | |
|     |   |   |   |     |     |   |   |   | |   |   |   |   |
||| | | ||||| ||| | ||||| ||| ||||| ||| | | | ||||||| ||||| |
| | | |   |     |   | | |   | |         |     | | | | | | | |
| | ||||||| ||| | ||| | ||| ||| ||| | | | ||| | | | | | | | |
| | |   | | |   | |   |     | | | | | | | | |   | |   |     |
| | | ||| ||| ||| ||| ||||| | | | | ||||| | | | | ||| | | | |
| |   | |   |   |   |   | | | |   |   |   |   |         | | |
| | ||| ||| ||||||||| ||| ||| | ||||| ||||||| | ||||| | |||||
| | | |   |   |   |     | | | |     |   |   | |     | | | | |
| | | | ||| | | ||| ||| | | | ||| ||| | | | ||| | ||| ||| | |
| |     | | | | | | | | |   | | |   | |   | |   | | | |     |
| ||| ||| | ||| | | | | | ||| | ||||| ||||||||| | | ||||||| |
|             | | |   | |   |       |     | | | | | |     | |
||| ||| ||||| | | | | ||| | | | ||||| ||| | | | | | ||| ||| |
| | | |     | |   | | |   | | |       |     | | | | | |     |
| ||| | | | ||| | | | ||| ||| ||||||| | | ||| ||||| | | |||||
| |   | | | | | |   | | |       | |   | |   | | |     |   | |
| ||| | ||||| | ||||||| ||| | | | | ||| ||| | | ||||| | | | |
|                     |     | |   |   |   | | | | |   | | | |
| | | ||||||| | ||| ||||| | | ||| | | ||||||| | | | ||| ||| |
| | |   | |   | | | |   | | | |   | |   |     | |     |   | |
| | ||| | ||||| | | | ||||||| ||| | | | ||| | | ||| ||||| | |
| |   | | | |   | | |     |     | | | | | | |   |         | |
||||| ||| | | ||| ||| | | | ||||| ||| | | ||| | ||| | ||||| |
| | |     |   |     | | |   |   |   | |   | | | | | |   |   |
| | | | ||||| ||| ||||| ||| | ||||| | | | | ||| | ||||| | |||
|   | | |   |   |   |   |         | | | | | |       |   |   |
||| ||||| | | ||||| ||||| ||||| ||| ||| | | | ||| | | ||| |||
| |       |     |           | |   | | | | | |   | |   |   | |
| ||||||| ||||| | ||||||||| | ||| | | | ||| ||| ||| ||| | | |
|     |   | |       |     |     | |   | | | |   | |   | | | |
||| | | | | ||||||| | ||| ||||||| | | | | | ||| | ||| | | | |
|   |   |       | | | | |   |   | | | |   |   |     | | | | |
| | ||| ||| | ||| | | | ||| | ||||||| ||| | ||| ||||||| ||| |
| | |     | |     | |     | |     | |   | | |             | |
| | ||||| ||| ||| | | | | ||| | | | | | ||| | ||| | ||| | | |
| | | | | |     | |   | |     | | | | | |       | |   | | | |
||||| | | | ||||||| ||||| ||| ||| | ||||||| | ||||||||| | | |
| |   | | | |   |       | | | | |     | |   |       | | | | |
| | ||| | | | ||||| ||| | | | | ||||| | ||||||||||||| | | | |
| |       |     |     | | | |     | |   | | | | | |   | |   |
| | ||||||| | ||||| | | ||| ||| | | ||||| | | | | ||| ||||| |
| | |     | | | |   | |     |   |   | |     |         | | | |
| | | ||||||||| ||||||||| ||| ||||| | | ||||||| | ||||| | | |
|     | |                 |       |       | |   |   | |     |
| ||||| | ||||||||||||||| | | | ||||||||| | ||| | ||| ||| |||
| | | |   | |     |       | | |   | |   |   |   | |         |
| | | | | | | | | | | ||| ||||||| | | ||| | ||| | | ||| ||| |
|   |   |     | | | |   |                 |     |     |   | |
|||||||||||||||||||||||||||||||||||||||||||||||||||||||||||||
