|||||||||||||||||||||||||||||||||||||||||||||||||||||||||||||
|     | | | | | | | |     |   |     |         | |       | | |
||| | | | | | | | | | | | | ||||||| | ||||| | | | | | ||| | |
| | |   |             | | |   | | |   |   | | |   | | | | | |
| | ||||||||| | ||| ||||||| ||| | | ||| ||||||| ||||| | | | |
| |       | | | |     |   | |         | | |   |     |   | | |
| ||| | | | | | | ||||| | | | ||| | ||| | | | ||| | ||| | | |
| | | | | | | | |     | | | |   | | |       | |   |   | |   |
| | | | | | | | | | | | ||| | ||||||||| | | | ||| | | | | | |
| |   | | |   | | | | |     | |   |     | | | | | | | | | | |
| | ||| | ||||| | | ||| ||| | | | | ||| | ||||| | ||||||||| |
| |   | | | |   | |   | | | |   |   |   | | |     |     |   |
| | ||||||| | ||||||||||| | ||| ||| ||| | | | | ||||| | | |||
| |       | |   |         | | |   | | | |   | |   | | |     |
| | | ||| | | ||| | ||| ||| | ||||| | ||||||||||| | | | | | |
|   | | |       | | |       | | | | |     |           | | | |
||| ||| ||| | | | | ||||| | | | | | ||||| | | ||||||| |||||||
| | |   |   | | | |   |   | |     |     | | |       | | |   |
| ||| ||| ||| | | | ||||||| ||||| ||||| | ||| ||| ||| | ||| |
|   |   | | | | | |       | |       | | |       |   | |     |
| | | | ||| | ||| | ||| ||| ||| ||| | | ||||| ||||| ||| | |||
| |   | | | | | | |   | | |     | |     | | | | | | | | | | |
||||| ||| | | | ||| ||||| | ||| | ||||| | | | | | ||| | ||| |
| | |       | | | | | | | |   | |   | | | |   |       |     |
| | ||| ||| | | | | | | | | ||||| | | | | | | | ||| ||| | | |
|     |   |   | |   | | |     | | |   |   | |     |     | | |
||||| ||||| ||| | | | | | | | | | | | ||||| | | | ||||| |||||
|   |     |     | |     | | | |   | | | | | | | | |       | |
| ||| | ||| | ||||||||| ||| | | | | ||| | | | | ||||||| | | |
|   | |     | | |   |     | | | | |     | | | | |   | | | | |
| ||| | ||||| | | ||||||| ||| ||||||||| | ||| | ||| | ||||| |
|     |   |       |   |     |     | |     |   |   |   |     |
||||||| | ||||||| | ||| ||| ||| ||| | ||| | | ||| | | ||| | |
|   |   |     | |   |     | |     |     | | | | | | |     | |
||| ||| ||| ||| | ||||||| | | | ||||||| ||||||| | | ||| ||| |
| | |     | | | |       | | | |     | |       | |     |   | |
| | | | | | | | | ||| ||| ||| ||| | | ||| ||||| | | |||||||||
| | | | | | |     |     | |     | |     | |   | | | |   | | |
| | | ||| ||| ||||||| | | ||| ||||||||||| ||| | ||| | ||| | |
|     | | |   | |     |   |       | | |   | | | |         | |
||| | | ||| ||| | ||| ||| ||| ||||| | | | | | | ||| | | ||| |
|   | | |   |       | | | |       | |   |   |   | | | |     |
| | ||| ||| ||| | | | | ||| ||| ||| ||||||| ||| | | | ||| |||
| | |     |   | | | |     | |         | | |     | | |   | | |
| | | ||||||| ||| ||| | ||| | ||||| | | | | ||| | | | ||||| |
| |   |   | | | | |   |   | |   | | | | | | |       | |   | |
| | ||| | | | | | | ||| ||||||| | ||| | | ||||| | | ||| ||| |
| | |   | |     | |   |     |   |     |       | | | | | | | |
||| | | | ||| ||||||||||| ||| | | | ||| ||| ||| ||||| | | | |
|     | | | |   | | |   |   | | | | | | | |     |           |
||| | | ||| ||||| | | | | | | ||||||| | | | | ||| |||||||||||
|   | | |   | | |   | |   | | | |     | | | | | |   | | | | |
| | ||||| | | | | ||| | | ||||| ||||| | | | ||| | ||| | | | |
| |     | |       |   | | | |   | | |   |   |       |   | | |
| ||||||| ||| | | ||||||| | | ||| | ||| | | | ||||| ||| | | |
|   | |     | | | |       | | |   | |   | | | | |   | |     |
| | | | ||||| | | | | | | | | | ||| | ||| | | | | ||| | | |||
| |     |   | | | | | | | |   |   |     | |   |         |   |
| ||||| ||| ||| ||| | ||| ||| ||| ||||||||||||||||| ||| | |||
|     |       | |   | |                                 |   |
|||||||||||||||||||||||||||||||||||||||||||||||||||||||||||||
