|||||||||||||||||||||||||||||||||||||||||||||||||||||||||||||
| |   | |   |   |   | | | | | |   |   |   |         |     | |
| | ||| | ||| ||| | | | | | | ||| | ||||| | ||||| ||| ||||| |
|     |   |   | | | |     |     | | | |   |     | |     |   |
| ||||||| | ||| | | | ||| | ||||| | | | | ||| ||| ||||| | | |
| |     | | | |   | |   | |           | |   |   | |   | | | |
| | ||||| | | ||| | ||| | ||||||| | | | ||| ||| ||| | | ||| |
| |   | | | |   | | |   | |   | | | | |   |   |   | | | | | |
| ||| | | | | | | | | | ||||| | ||| | | ||| ||||| ||| | | | |
|   |   | | | |   |   | | | | | | | |   |     | |   | | |   |
| | | ||| | | ||||| ||||| | | | | | | | ||| ||| | ||| | | |||
| | |   |   |   |   |   |   |   |   | |   | | |     | |     |
||| | ||||| ||||||| | ||||| | ||||| | | ||| | ||||| | | ||| |
|       |   |   |   | | |       | | | | |   |     |       | |
| | | ||| ||| ||| ||| | | | | ||| ||| ||| ||| | ||||| | | |||
| | | |   | |     |     | | | | |     |   | | | |     | |   |
| | ||| ||| ||| ||| ||||| | | | ||| | | | | | ||||||| | | | |
| | |   |   | |       |   | | |     | | | | |     | | | | | |
| ||| ||| ||| ||||| | ||| ||||||||||| ||| | | | ||| | | | |||
|           | |   | | | | |           | |     |     | | | | |
| ||||||||||| ||| | ||| | ||||| ||||| | ||| ||| ||||||| ||| |
|     | |     |   |               |   |   | | | | | | | |   |
| ||||| | ||| | | | ||| ||||||| ||| ||| ||| | ||| | | | | |||
|   |     |   | |   | | | | | | |     |     |   | |         |
| | ||||||| ||| | | | ||| | | | | ||| ||||||| ||| | ||| |||||
| |   | | |     | |       | |   | | |     |         | | |   |
| | ||| | ||||||| | ||| ||| ||||| | ||||| | | ||| ||| | | |||
| |       | |   | |   | | |   | | | |   |   |   | | |   |   |
| | ||| | | | ||| | ||||| ||| | | | | ||||||| ||||| | | ||| |
| | |   | |   | | |   |     |             | | | | |   | |   |
||| ||||| | | | ||| ||||||| | ||| | | ||| | ||| | | | ||| |||
|     |     |       | | |       | | |   | | |   |   |   |   |
||||||||| | ||| | ||| | ||| | | | ||| | | | | ||| | | ||| |||
|   | | | | |   |     | | | | | | | | | |   | |   | | |   | |
| | | | | | | ||| ||||| | ||| | | | ||| ||||| | | ||||| ||| |
| |   |   | | |     |       | | | |       |   | |         | |
| ||||| | ||| ||| | | ||||| | | ||||||| | | ||| | | | ||| | |
| |   | | | | | | | | | |   | |       | | | |   | | |   | | |
| | ||| ||| | | ||| ||| ||| ||||||||| ||||| | | | | ||||| | |
|           |   | | |   | |   |   | | | |   | | | |   | | | |
| ||||||| | ||||| ||||| | | | | ||| | | ||| | ||||| | | ||| |
|   | | | |   | | |     | | |       | |     | | |   |     | |
||| | | | | ||| | | | ||| ||| ||| | ||||| | | | | ||||||| | |
| |     | | | | | | |       |   | | | | | | |   |       | | |
| ||| | | ||| | | | | | | ||||| ||| | | | ||||||| ||||||||| |
| | | | |       |   | | | |       |   |     | | |     | | | |
| | | | ||||||||| ||||| | ||| | ||| | ||| | | | ||| | | | | |
|     | |   | | | | |   |   | | | | |   | |     | | |     | |
| ||| | | ||| | ||| ||| | | ||| | | | | ||| ||| | | ||| | | |
| |   | | | |   | | |   | | |     | | |       |       | | | |
| ||||||| | ||| | | | ||||||| ||| ||| ||||| ||||| | | ||||| |
|   | |   | |     |     | |     | |   |         | | |     | |
| ||| | ||| | | ||| ||||| ||| ||||||||||| | ||||| ||| ||||| |
| |   | | |   | |   |       | |     |     | |   | | | |   | |
||||| | | ||||| | ||||||||| ||| ||||||||| ||| | | | ||| ||| |
| |           | | |   | |     | | |       |   | | | | |   | |
| | | | ||| | | | | ||| ||||| | | | | | | | ||||||| | | ||| |
| | | | | | |             | | | |   | | |       |   | | | | |
| | ||| | | ||| ||| ||| | | | | ||||||| ||||| ||| ||| | | | |
|   |     |   |   |     |                                   |
|||||||||||||||||||||||||||||||||||||||||||||||||||||||||||||
