|||||||||||||||||||||||||||||||||||||||||||||||||||||||||||||
|         |       |     |   |     |     | |   | | |     |   |
||| ||| ||||||||| | ||| | ||| | ||| | ||| | ||| | | ||| ||| |
|     | | |   |   | |         | | | | |     |         | |   |
||| ||| | | ||| | ||||||||| | ||| | ||||| | ||||||| ||| | | |
|   |           |   |     | | |   | | | | |   | | | | |   | |
| ||||| ||||||||||||||| | | ||| | | | | | ||| | | ||| | | |||
| | | | | | |       | | |     | | |   | | | | |   | | | | | |
| | | ||| | ||| | ||| ||| ||||||| | | | | | ||| ||| | | | | |
| |         |   | |   |   |   | |   | | | |   | |     | | | |
| | | | ||||| ||||| ||| | ||| | ||||| | | | | | ||||| ||| | |
|   | |   |   | | | | | | |     |   |   |   | | | | |       |
| ||| ||||||| | | | | | | ||| ||||| | | | ||||| | | ||| | |||
| | |   |               |       | | | |     | |   |   | |   |
| | ||||| ||| ||| ||||||||||| | | | ||||| | | | | | | | | |||
|   |       |   |     |     | |     | | | | | | |   |   |   |
| ||| | | ||||| ||| ||||| ||||| ||||| | | | | | ||||||| ||| |
| |   | |     | | | |     |               | | |     | | |   |
| | ||| ||||||||| | | | | ||||| ||||||||||| | ||| ||| |||||||
|     |       | | |   | |     | | | | |   |   |     |     | |
| ||| | ||||| | | | | | | ||| | | | | ||| | ||||| ||| | ||| |
|   | |     |     | | | |   | | |                 | | |   | |
| | | | | ||| ||||| | | ||| ||| | ||| ||||||||| ||| ||||| | |
| | | | |   |   |   | |   | |   | | | | |   | |   |   |   | |
| | | ||||| ||||||| ||||||| | ||||| | | | ||| ||| ||| ||| | |
| | |   | | |     |   | | | | |     |     | |       | | | | |
| ||||| | | | | | ||| | | ||| | ||||||||||| | ||| | | | | | |
| | | |   |   | | |         |     |   |   |     | |     |   |
| | | ||||||||| ||| ||| ||||||||||| | | | ||||||| ||||| | | |
|       |   |   |     | |   |       | | | |   | |     |   | |
| | | | ||| ||||| ||||| | ||||||| | ||| | ||| | | | ||||||| |
| | | | |   | | |     |     |     | |   |       | | |   |   |
||||||| ||| | | ||| ||| | ||||| ||||| | | ||| ||| ||| ||||| |
| | | |   | | | | |   | | | |     | | | | |   | | |         |
| | | | | | | | | | | | | | | ||| | | ||||||||| ||| | ||||| |
| | |   | | | |   | | | | |     |     | | | | |     | |   | |
| | | | | | | | ||| ||||| | ||||| ||| | | | | | | | | | |||||
|     | |   |           | |   | | |       | |   | | | | |   |
| ||| | | | | ||||||| | ||| | | ||||||||||| ||||| ||||| ||| |
| |   | | | | |   |   |     |   |   | |   | |   | |         |
||||| ||||| | | ||||||| ||| | ||| ||| ||| | | ||| ||| |||||||
| |   | | | |     |     | | |   |     | |           | | | | |
| | ||| | | | ||||| | | | | ||||||||| | ||| ||||||||| | | | |
|     |     |   | | | | | |   |     | | |     |     |   | | |
| ||||| | ||| | | | ||||| ||||| ||||| | ||||| ||||| | | | | |
| |     | |   | | | | | | | | |   |   |   |   | | | | |   | |
| ||||| | | | | | ||| | | | | ||| | ||||| | ||| | | | ||| | |
| | |   | | | | | |     |       | |   |     |   |     |   | |
||| ||||||| ||||| | ||| | ||||||| | | ||||| ||| | ||| ||||| |
| |       |   | |     | |     | |   |     |     | |   | |   |
| | ||| | | ||| ||| | ||| ||| | | | | ||| ||||| ||| ||| ||| |
|   |   | | |   | | | | |   | |   | |   | |   |           | |
||| ||| ||||| ||| | | | ||||| | ||||| | | ||| | | | | | ||| |
|     | | |       | |   | |     |   | | | |     | | | |     |
| | | ||| ||| | ||| ||| | ||||| | ||| | ||||| | | | | | ||| |
| | | |       |     |             |   |       | | | | |   | |
| ||||||| | ||| | | | | | ||| ||| | | ||||| | ||||| | |||||||
|   | |   |   | | | | | |   |   | | | |     | | |   |       |
||| | ||| | ||| ||| | ||||||||||||| | | ||| | | | | | |||||||
|         |   |   | |               | |     | |   | |       |
|||||||||||||||||||||||||||||||||||||||||||||||||||||||||||||
