|||||||||||||||||||||||||||||||||||||||||||||||||||||||||||||||||||||||||||||||||||||||||||||||||||||
|     | | | |   | | |     | | | | |     | | |   |       | |     |   |     |   | | |   |   | | |     |
| ||||| | | | ||| | | | | | | | | ||| ||| | | ||| | | ||| ||| ||| ||||||| | | | | ||| | | | | ||||| |
| | | | | | | | |   | | | | |     | |       |     | |     | |   | |   |   | |   |       |   |     | |
| | | | | | | | | ||| ||||| ||| | | | | ||||| ||| | ||| | | ||| | | ||||| | ||||| | ||| | ||| | ||| |
| | |       | | |   |   | |     | |   |         | |   | |     |     |           | |   | |     | |   |
| | ||| ||||| | | ||| ||| | | ||||| ||||||||||| | | ||| | | | | | ||| | | | ||| ||| ||| | ||| | ||| |
|   | |           | | | |   | | | |     | | |   | |   | | | | | |     | | | |   |   | | |   | | |   |
| | | | | ||||| | | | | | | | | | ||||| | | ||||||| ||| ||||| ||||| ||| ||| | | ||||| ||| | | | | |||
| |   | |     | |       | | |     |   | |       |     |     |   |   | | | | | |   |     | | | | | | |
| ||| | | | | ||| ||| | ||||| ||| ||| | ||||||| | | | ||| | | ||||||| | | ||||| ||||| | | ||||| | | |
| | | | | | | |     | | | | |   | | | | | | | | | | |   | | |       |   |   |       | |   | | | | | |
| | | | ||||| ||||||||| | | ||||| | | | | | | | | ||| | | | | | ||| | ||||| | ||||||||| | | | | | | |
|   | | |   |   |         | | | | |   |     | |   |   | | | | |   | |     | | |     |   | | | | |   |
||||| ||| ||| | | ||||| | | | | | ||| | ||||| | | ||| | | ||||||| | | | | | ||| ||||| ||||| | ||||| |
| | |     |   | | | | | |     |     | |   |     | |   | | |   | | | | | | |   |   |   | |     |     |
| | | ||| | | | ||| | ||| ||||| ||||| ||| | | | | ||| ||| ||| | | | ||| | | ||| ||| ||| | ||||| ||| |
| |   |     | |     | | | |     | | | | | | | | |   |   | | | | | | |   |     | |         |   | |   |
| ||| ||| ||| | | | | | | ||||| | | | | | ||| | ||||| | | | | | | ||| ||| ||||| ||| ||||| | ||| |||||
| |   |     | | | | | | |   | | | |   |   | | |   | | | | | |   | |     |   | | | | |     |     |   |
| ||| | | ||| ||| | | | | ||| | | ||| | | | ||| ||| ||||| | | ||| | | | ||| | | | | | ||| | ||||| | |
| |   | |   |   | | |   |       |   |   | | |   | |   | | | | | | | | | | | | |   | |   |   | | | | |
| | ||||||| | ||| ||||| | ||| | | | | ||| | ||||| | | | ||| | | ||| ||||| ||| | ||| ||| | | | | ||| |
| | | |     | | | |   |     | | | |     |     | |   |     |     |   |   |   | | |   | | | | | | | | |
| | | ||||| | | ||| ||||| | ||| | ||||||| | ||| | ||| | | | ||||| ||| | ||| | | | | | | ||| | | | | |
|     | |   | |   | |   | | | |   |     | | |     |   | |       |     |   | | | | | |     | | | |   |
| | ||| | ||| | ||| | ||||||| ||| | | | | | ||| ||| ||| ||| | | ||||| ||||| | | | ||||||||||| | ||| |
| | | | | |     | |   | |   |   | | | |   |   | | | | | |   | |     | |     | |   | |   | |   | |   |
||||| | ||| ||||| ||| | | ||| ||||||| | | ||| ||| ||| ||||||| | | | | ||| | | | ||| | | | ||| | | |||
|   |   |       |   | | |   | | | | | | |   |     | |   | |   | | |       |     | |   |   |     |   |
| ||| ||| | ||||||| | | | | | | | | | | | | | ||| | | | | | ||| ||| ||||| | ||||| | ||||||| ||||| |||
|   | | | |             | |   |       | | | | | |   | | |   | | |   | |   |     |   | | |     |   | |
| | | | ||| ||||||| | | | | | ||| | | ||| | | | | | | | | | | ||| ||| ||| ||| ||| ||| | | ||||||| | |
| |     | |   |     | |   | |   | | | | | | | | | |   |   | |           | | |   | |       |   | |   |
| ||| ||| ||| ||| ||||| | ||| | | ||||| | | ||| | ||||| | ||||| | ||| ||||| | ||| | | | ||| ||| ||| |
| | | | | |     |   |   |   | | |     |   | | |     |   | |   | | |     |   |       | |     | | | | |
| | ||| | | | ||| | ||| ||||| | ||| | ||||||| | ||| | | ||||| | | | | ||| | | ||||||| ||| | | | | | |
| |         | |   | |   |   | | | | | | | |   | |   | |   |     | | |     | | | |     |   | |   |   |
| | ||||||| | ||| ||| ||| ||| ||| ||||| | | | | ||| ||||||| ||||||| ||| | | | | ||||| | ||| | ||| |||
|   |   |   |   | |         | | |   | |     | | | |     | | | | | | |   | | | |       |   | | |   | |
| | ||| | | ||||| ||||||||| ||| | | | | ||||||| | ||||||| | | | | ||||||||| | ||| ||||||| ||| | ||| |
| | | |   | |     |   | | |       | | | |     | |   | | | | |   |   | |     |   | |   |     |   |   |
||||| | | | | | | | | | | ||||| ||||| | | ||| ||| ||| | | | | | | ||| ||||| | | ||| ||| | | | ||||| |
| |   | | | | | | | | |   | |   |     |   | |     | | | |   | |       | | | | | | |   | | | |       |
| | ||||| ||||||||| ||| ||| ||| | | ||| | | ||| | | | | | ||| | | ||| | | | | | | | ||| ||||| | |||||
|     | |         |     | |   | | | | | | |     |       | |   | |   |   | | | | | | | |     | | | | |
||||| | | | | ||||| ||||| | | ||| ||| | ||| ||||||| | | ||| ||| | | ||||| ||| | | | | ||| | | ||| | |
| |   |   | | | |   | |     |   | |   |   |   | |   | |     | | | |   |       | | | | |   |   |     |
| | ||| ||||| | ||| | ||| ||| | | ||| | ||| ||| ||| ||| | | | | | ||||||||| | ||| | | ||| ||| | |||||
| | | |   |     | | |     |   | | | | | |     | |     | | | | | |   |   | | |   | | | |     |     | |
| | | | | ||||||| | | | ||| ||||| | | | | ||| | ||| | | ||| | | | | ||| | | ||||| | | ||||||| ||||| |
|   | | |   | | |     | | | | | |   | | |   |     | | |   | | | | | | |   | | | | |         | |     |
| | | ||||||| | ||||| | | | | | | | | ||| ||| | | | ||| ||| | | | | | | ||||| | | | | | | ||| | | |||
| | |   |   | | |   | |   |   | | | | | |   | | | | | |   | |   | | |       | |   | | | | |   | |   |
| ||||| | | | | | | ||| | ||| | | | | | | ||| | | ||| ||| | | | ||| ||| ||||| | | ||||||| | | | |||||
| |   |   | | | | | | | | | | | | | |   | | | | |       | | | | | |     | |   | | |   | |   |   |   |
| | ||| ||| | | ||| | | | | ||| | ||| ||||| ||| ||| ||||||| | | | ||| | | ||| | ||||| | ||| ||| | | |
| | |     |   | | |     |   |   | |     |   |     | | | | | | | | |   |     | |               |   | |
| | ||| | ||||| | ||| ||| | ||| | | ||||| ||| ||| | | | | | | ||| ||| | | ||| | | | | | ||| | | ||| |
| |     |       |   | |   |   |     |   |       | | |   |   |   | |   | |   | | | | | |   | | |   | |
| | ||||||||||||| | ||||| ||||| ||| | | | ||||||||| | ||||||| ||| | ||||| | | ||| ||||||| | |||||||||
|       |       | | |   | |   |   |   | |         | |   | |       | | | | | | |     |     | | |   | |
||| ||| ||||| ||| ||| | | | | | | ||||| ||||||||| | ||| | ||||| ||||| | ||| | | | ||||||| | | | ||| |
|     |     |   | |   |     | | | | |   | | | | | | |   | | | |   |     | | |   | | |   | | | | | | |
| | | ||| ||||| | | | | | ||| | ||| | ||| | | | ||| | ||| | | | | ||||| | | ||| | | | ||| | | | | | |
| | | |     | |     | | | |   | |       | |     | |       |   | | |         |   | |       | |       |
||| ||||||||| ||||||||| ||| ||| | | ||| | | ||||| ||| ||||| ||||||| ||||||| | ||| | | ||| | | | | |||
|   |   | | | |     |   |   |   | |   |     |   |   | |   |   |   | | |   | | |   | | |   | | | |   |
| | ||| | | | | | ||| ||||| | ||| | ||||||||| ||||| ||| | ||| ||| | | | ||| ||| ||||||||||| ||||||| |
| |       |     |     | | |   | | | |   | | | | | |     | |   | |     |   |   | |       | | | |   | |
| | ||| | ||||| ||| ||| | | ||| | | | ||| | | | | ||| ||| | ||| | ||||| | ||| ||| ||||| | | | | | | |
| |   | |         | |     |     | |       | | | | | | |   | | | | |     | | |   | | | |   | |   |   |
| ||||||| | | | | | ||| ||||||||||| ||| | | | | | | ||| ||| | | | | | | | | ||| | | | ||| | ||||| | |
| | | |   | | | | |   | | | | | |     | | | | | | | | |   |   |     | | |   | | | |   |       | | | |
| | | ||||| | | ||||||| | | | | ||||||| ||| | | | | | | ||| ||||||| ||| ||||| ||||| | ||||| | | ||| |
| | |   |   | | |       |   |   | |       | |       |   | | | | |   | | | |   |     | |   | |     | |
| | | | ||| | ||| ||| ||| ||| ||| ||||||||| ||| | ||| | | | | | | | | | | | ||| | ||||| ||| ||||| | |
| |   |   | | | |   | |         | | | |   |   | |   | | | | | |   |   |         |         |     | | |
| | | ||||||||| ||| | ||||| ||||| | | | | | | ||| ||| ||| | | | ||||||| ||||||| ||| ||| ||||| ||||| |
| | | |     |   |   |     | |     | | | |   |         |   | |   | |   |       | | | |   | |         |
| | | | | ||| ||| | | | | | | ||||| | ||||| | ||||| ||| ||| | | | | ||||| | ||| | | | ||| | | | ||| |
|   |   |         | | | | |   |     | | | | | | | |     | | | | |   | |   | | | | | |   |   | | |   |
||||||| ||| ||| ||| ||| ||||| | ||||| | | ||||| | | ||||| | ||| | ||| ||||| | ||| ||||| | | | |||||||
|         | |     | |   | |       |         |     | |       | |   |   | | | |   | | | |   | |     | |
||| | | | ||| | ||||||| | | ||||| | ||||| | ||| | | | | | ||| ||| | ||| | | | ||| | | | | | | | | | |
|   | | |   | | |   |     | | |     |     |   | |   | | | | | |     | |   | |   |   | | | | | | | | |
||| ||| | ||||||| ||||| ||| | ||||||| | ||||| | ||| | ||||| | ||| | | | ||| | | | | | ||| ||||| | | |
|     | |             | |         |   |     | |   |     |     |   | |     |   |   | |     | |   | | |
| ||| ||| ||||||||| | | | | ||||| ||||||| | | | | | | ||| | | | ||||| | | ||||||| ||| | ||| ||| ||| |
| |     | | |       | |   |   | |   | |   | | | | | |   | | |   |     | |     | |   | | |   |   |   |
| ||| | | | ||| ||| | ||| ||| | | | | ||| ||| ||| | | | ||| ||| | ||||||||| | | ||||||||| | ||| ||| |
|   | | | | |     | |   | |   | | | |       | | | | | |   | | | |   |       |     |     | | |       |
||||||||||| ||| | ||| | | | ||| | | ||||||||| | ||||||| | | | ||||||||||||||||||| ||| | | | |||||||||
|     |         | | | | | |   |   |         |   | | |   |     | | | |         |   | | |   | | | | | |
| | | | ||| ||| ||| | ||||| ||||| ||||| ||| | ||| | | ||| | ||| | | | ||| | | ||| | | | ||| | | | | |
| | |     |   |     |   |   | | | |       | | |   |     | |   | |       | | |   |     | |   |     | |
||||||| ||||| | ||||| | | | | | ||||| ||| ||||||| ||| ||| | | | | ||||||||| | ||| | | ||||||||| ||| |
|       |     |     | | | | | | | | | |     |       |   | | | |   | |   |   | |   | |   | | |     | |
| | | ||||||||| ||||| ||||| | | | | | ||||||||| ||||||| | ||||| | | ||| | ||| ||||| ||||| | | | | | |
| | |             |                                     |       |           |                 | |   |
|||||||||||||||||||||||||||||||||||||||||||||||||||||||||||||||||||||||||||||||||||||||||||||||||||||
